201110000011102
011000111000110
113000000020011
100000000000001
100111111111001
000000000000300
000000040000000
100111111111001
100000000000001
113020000000011
011000111000110
201110000011102