111110000111111
100010020010021
102010000001301
130011111000101
111110000000011
001000301001001
001000201101201
111001000001000
101101110001000
121111000011111
101001040000231
111001000011111