231110110300002
001210011111110
011110001300010
012100001012011
111100001011010
121003001000010
111000001111111
030000000000100
001111110000102
111210000000100
001010040111111
001110000010200